52 51 0.95                                         
OOOOOOOOOOOOOOOOOOOOOOOOOOOOOOOOOOOOOOOOOOOOOOOOOOOD
S                                                  D
S                                                 RD
S                                                  D
S                                                 RD
S                                                  D
S                                                 RD
S                                                  D
S                                                 RD
S                                                  D
S                                                 RD
S                                                  D
S                                                 RD
S                                                  D
S                                                 RD
S                                                  D
S                                                 RD
S                                                  D
S                                                 RD
S                                                  D
S                                                 RD
S                                                  D
S                                                 RD
S                                                  D                          
SS                                                RD
SSS                                                D
SS                                                RD
S                                                  D
S                                                 RD
S                                                  D
S                                                 RD
S                                                  D                     
S                                                 RD
S                                                  D
S                                                 RD
S                                                  D
S                                                 RD
S                                                  D
S                                                 RD
S                                                  D
S                                                 RD
S                                                  D
S                                                 RD
S                                                  D
S                                                 RD
S                                                  D
S                                                 RD
S                                                  D
S                                                 RD
S                                                  D
OOOOOOOOOOOOOOOOOOOOOOOOOOOOOOOOOOOOOOOOOOOOOOOOOOOD  
                                                                  



